# @ # # # # # # # # # # # # # # # # # # 
# @ @ @ @ @ @ @ @ @ @ @ @ @ @ @ - - # # 
# # # # # - # # - # # - # # # @ # - - # 
# - # # # - # - - # # - # # - @ # - # # 
# - # - - - # # # # # # # # # @ # - - # 
# - - - # - - - - # - # # - # @ # # # # 
# - # # # # - # - - - - - - - @ @ @ - # 
# - # # - - - # # # # # # # # # # @ # # 
# - - - - # - - # # - - - - - - - @ @ # 
# # # # # # # # # # # # # # # # # # @ # 
