# @ # # # # # # # # # # # # # # # # # # 
# @ @ @ @ @ - - - - - - - - - - - - # # 
# # # # # @ # # - # # - # # # - # - - # 
# - # # # @ # - - # # - # # - - # - # # 
# - # - - @ # # # # # # # # # - # - - # 
# - - - # @ @ @ @ # - # # - # - # # # # 
# - # # # # - # @ @ @ @ @ @ @ @ @ @ - # 
# - # # - - - # # # # # # # # # # @ # # 
# - - - - # - - # # - - - - - - - @ @ # 
# # # # # # # # # # # # # # # # # # @ # 
